"filename", "language", "MonoGame Content Builder", "C#", "JSON", "comment", "blank", "total"
"/home/kayla/Documents/GitHub/ThermalSimulation/Content/Content.mgcb", "MonoGame Content Builder", 70, 0, 0, 7, 7, 84
"/home/kayla/Documents/GitHub/ThermalSimulation/Game1.cs", "C#", 0, -15, 0, -2, 0, -17
"/home/kayla/Documents/GitHub/ThermalSimulation/Tests/UnitTest1.cs", "C#", 0, 10, 0, -11, 0, -1
"/home/kayla/Documents/GitHub/ThermalSimulation/Tests/obj/Debug/net6.0/.NETCoreApp,Version=v6.0.AssemblyAttributes.cs", "C#", 0, 1, 0, 0, 0, 1
"/home/kayla/Documents/GitHub/ThermalSimulation/Tests/obj/Tests.csproj.nuget.dgspec.json", "JSON", 0, 0, -2, 0, 0, -2
"/home/kayla/Documents/GitHub/ThermalSimulation/Tests/obj/project.assets.json", "JSON", 0, 0, -133, 0, 0, -133
"/home/kayla/Documents/GitHub/ThermalSimulation/ThermalClasses/GameObjects/CheckButton.cs", "C#", 0, 12, 0, 0, 2, 14
"/home/kayla/Documents/GitHub/ThermalSimulation/ThermalClasses/GameObjects/GameObject.cs", "C#", 0, 0, 0, 0, 2, 2
"/home/kayla/Documents/GitHub/ThermalSimulation/ThermalClasses/GameObjects/ObjectCollections/RadioButtons.cs", "C#", 0, 71, 0, 0, 8, 79
"/home/kayla/Documents/GitHub/ThermalSimulation/ThermalClasses/GameObjects/ObjectCollections/SimulationBox.cs", "C#", 0, 7, 0, 0, 1, 8
"/home/kayla/Documents/GitHub/ThermalSimulation/ThermalClasses/GameObjects/ObjectCollections/Slider.cs", "C#", 0, 56, 0, 0, 8, 64
"/home/kayla/Documents/GitHub/ThermalSimulation/ThermalClasses/GameObjects/ObjectCollections/UpDownButton.cs", "C#", 0, 8, 0, 0, 1, 9
"/home/kayla/Documents/GitHub/ThermalSimulation/ThermalClasses/GameObjects/Particles/Polygon.cs", "C#", 0, -2, 0, 0, 0, -2
"/home/kayla/Documents/GitHub/ThermalSimulation/ThermalClasses/GameObjects/SliderButton.cs", "C#", 0, 47, 0, 1, 7, 55
"/home/kayla/Documents/GitHub/ThermalSimulation/ThermalClasses/Handlers/SimulationHandler.cs", "C#", 0, 113, 0, 8, 7, 128
"/home/kayla/Documents/GitHub/ThermalSimulation/ThermalClasses/PhysicsLaws/PhysicsLaws.cs", "C#", 0, 29, 0, 32, 7, 68
"/home/kayla/Documents/GitHub/ThermalSimulation/ThermalClasses/obj/Debug/net6.0/.NETCoreApp,Version=v6.0.AssemblyAttributes.cs", "C#", 0, -1, 0, 0, 0, -1
"/home/kayla/Documents/GitHub/ThermalSimulation/ThermalClasses/obj/ThermalClasses.csproj.nuget.dgspec.json", "JSON", 0, 0, -1, 0, 0, -1
"/home/kayla/Documents/GitHub/ThermalSimulation/ThermalClasses/obj/project.assets.json", "JSON", 0, 0, -1, 0, 0, -1
"/home/kayla/Documents/GitHub/ThermalSimulation/obj/ThermalSimulation.csproj.nuget.dgspec.json", "JSON", 0, 0, -3, 0, 0, -3
"/home/kayla/Documents/GitHub/ThermalSimulation/obj/project.assets.json", "JSON", 0, 0, -133, 0, 0, -133
"Total", "-", 70, 336, -273, 35, 50, 218